PPPPPPPPPPPP
PPPPPPPPPPPP
PPPPPPPPPPPP
PPPPXPPPPPPP
PPPPOPOOOPPP
PPPPOPOPOPPP
POOOAPDOOOPP
POPPOPOPPOPP
PVPPOPOPOOPP
POPPDOBPOPPP
POPVOOOPVPPP
POPOPPWPOPPP
POOOPOOPOOEP
PPSPPOPPOPPP
PPOPOOOTOPPP
PPOPOPPPOPPP
PPDOWOOOOPPP
PPVPPPPPPPPP
PPPPPPPPPPPP
PPPPPPPPPPPP
PPPPPPPPPPPP
PPPPPPPPPPPP