PPPPPPPPPPPP
PXOOOOOSSSSP
PPPPPPPOOOOP
PNNNNNNOOOOP
PNSOOKOOOOAP
PNOKVOOOAOOP
PNVOOOOOOOOP
PNOBOOOOBOOP
PNOOIOOVOAOP
PNOOODOOIOOP
PNBOBOOOOOOP
PNOVOOEOOOOP
PNOOIOOOAOOP
PNODOTOOOOOP
PNLOOOWOOOOP
PNNNNNNNNNNP
PPPPPPPPPPPP
OOOOOOOOOOOO
OOOOOOOOOOOO
OOOOOOOOOOOO
OOOOOOOOOOOO
OOOOOOOOOOOO
