PPPPPPPPPPPP
PXPPOVOOOOPP
POPPOPPPPBPP
POOOVOOOOOPP
PPPPOPPPPPPP
PVOOAPPPPPPP
POPPOOOBOOVP
POPPVPPPPPVP
POPPOPPPPPOP
PBPPOPPPPPTP
POOOBOOBOOOP
PPPPOPPPPPPP
PPPPOPPPBOEP
PPPPVPPPOPPP
PPPPOPPPOPPP
PPPPOBOOVPPP
PPPPPPPPPPPP
OOOOOOOOOOOO
OOOOOOOOOOOO
OOOOOOOOOOOO
OOOOOOOOOOOO
OOOOOOOOOOOO