PPPPPPPPPPPP
PNODOTOPPPPP
PPPPPPVPPPPP
PPPPPPOPPPPP
PPPPPBBBPPPP
PPOOOOOOOOOP
POOOOOIOOOOP
POOOOOOOOOOP
POPOOOLOOOXP
POOOONNNOOOP
POOOOOOOOOOP
POOOKOOKOOAP
POOPOOOOOOOP
POOOOOOOOOOP
POKOOOOAOOOP
PONNENNNOOOP
PPPPPPPPPPPP
OOOOOOOOOOOO
OOOOOOOOOOOO
OOOOOOOOOOOO
OOOOOOOOOOOO
OOOOOOOOOOOO