PPPPPPPPPPPP
PPPPPPPPPPPP
PPPPPPPPPPPP
PNNNNNNNNNNP
PNLOOBOKOENP
PNOOOOOTOONP
PNOOLOOBOKNP
PNBOOOOOOONP
PNOOOOOOOONP
PNOOBXOKOBNP
PNVOOOOOOONP
PNOOOOOOOONP
PNOOIOOJOONP
PNBOOOOOOVNP
PNOOOOOOOONP
PNOOOOOOOONP
PNIOOBOOOJNP
PNNNNNNNNNNP
PPPPPPPPPPPP
PPPPPPPPPPPP
PPPPPPPPPPPP
PPPPPPPPPPPP