PPPPPPPPPPPP
PPPPPPPPPPPP
PPPPPPPPPPPP
PPPOPPPPPPTP
PPDOOVVOBOOP
POOOOOPPPPPP
PPOOKOOXPOOP
POOOOOOOOOOP
POPOOOOOOOOP
PPPOPPPPPPOP
POOOOOOOOOJP
POOPPPPPPPOP
PVOOOBBOOOOP
POOLOOOOOKWP
PBAOOOVOOOOP
PODOPPOOKOPP
POOPPPOOOPPP
POOPPPOOOOOP
PPPPPPPPEPPP
PPPPPPPPPPPP
PPPPPPPPPPPP
PPPPPPPPPPPP