PPPPPPPPPPPP
PXPPPPPPPPPP
POPPPOBOOOPP
POPVPOPPPOPP
POPOPOPPPVPP
POPOPOPPPOPP
POOVOOPPPOPP
PPPOPOPPPBPP
PPPBPOPPPOPP
PPPOPOPPPOPP
PPPVPTPOOOEP
PPPOPOPOPVPP
PPPBPVPBPOPP
PPPOPOPOPOPP
PPPOOBPOVOPP
PPPPPPPPPPPP
PPPPPPPPPPPP
OOOOOOOOOOOO
OOOOOOOOOOOO
OOOOOOOOOOOO
OOOOOOOOOOOO
OOOOOOOOOOOO