PPPPPPPPPPPP
PPPPPXPPPPPP
PPPPPOPOOOPP
PPPPPOPOPOPP
PPOOOAPDOOOP
PPOPPOPOPPOP
PPVPPOPOPOOP
PPOPPDOBPOPP
PPOPVOOOPVPP
PPOPOPPWPOPP
PPOOOPOOPOOE
PPPSPPOPPOPP
PPPOPOOOTOPP
PPPOPOPPPOPP
PPPDOWOOOOPP
PPPVPPPPPPPP
PPPPPPPPPPPP
OOOOOOOOOOOO
OOOOOOOOOOOO
OOOOOOOOOOOO
OOOOOOOOOOOO
OOOOOOOOOOOO