PPPPPPPPPPPP
PPPPPPPPPPPP
PPPPPPPPPPPP
POOOPXPOOOPP
POOOOOLOOBOE
POOOOOOOOOPP
PPPOOOOOOPPP
PPOOOAVOOOPP
POOOOOOOOOOP
POOOOPOOOOOP
POBOOPWOOJOP
POOOOPOOOOOP
POOOOOOOOOOP
PPOOOVOOOOPP
PPPOOOOOOPPP
POOOOOOOOOOP
POOOOOOOOOOP
POOOOOOOOOOP
PPPPPPPPPPPP
PPPPPPPPPPPP
PPPPPPPPPPPP
PPPPPPPPPPPP