PPPPPPPPPPPP
PPPPPPPPPPPP
PPPPPPPEPPPP
PTPOOOOKNNNP
POPLNNNIPPPP
PBPOOOONOOOP
POOIBOOVOOJP
PPPOOOOOOOOP
POOOOOOOOOOP
PLOOOOOIOOOP
POOOOOOOOOPP
PLOOOOOOOOOP
POPPPPPPPPVP
POPPPPPPPPOP
PBPPPPPPPPBP
POVOOVOOOOOP
PPPPOPPPPOPP
PXOOIOOOOWNP
PPPPPPPPPPPP
PPPPPPPPPPPP
PPPPPPPPPPPP
PPPPPPPPPPPP