PPPPPPPPPPPP
PNNNNNNNNNNP
PNDTOOJOOKNP
POKOOOOAOONP
POOOOOOOOONP
PDOOOOOIOONP
POOOOOOOOANP
PBOOPPOPPONP
POOLOOXOKINP
POOOPPOOOONP
PVOOPPOPDOOP
POEOOOOOOOOP
POOVOOAOOOOP
PPPOOOOOOOOP
PPPOOOOOOOPP
PPPPPPPPPPPP
PPPPPPPPPPPP
OOOOOOOOOOOO
OOOOOOOOOOOO
OOOOOOOOOOOO
OOOOOOOOOOOO
OOOOOOOOOOOO